AULA VII - ANÁLISE E PROEJTOS DE SISTEMAS

- BENEFÍCIOS DO MODELO DE CASOS DE USO
CLIENTE: CAPTURA E VALIDA REQUISITOS, AJUDA A DEFINIR ESCOPO, ESTIMAR PRAZOS E CUSTOS, BASE PARA TESTES DE HOMOLOGAÇÃO
USUÁRIO: DESCREVE A INTERAÇÃO DO USUÁRIO COM O SISTEMA
GERENTE DE PROJETOS: AUXILIA EM ESTIMATIVA DE CUSTOS, RISCOS, RASTREAMENTO E MAPEAMENTO DE REQUISITOS
ARQUITETO DO SISTEMA: IDENTIFICA REQUISITOS ARQUITETURAIS, AVALIA TECNOLOGIAS, GARANTE CONSISTÊNCIA E COERÊNCIA
DESENVOLVEDOR: USA OS MODELOS COMO BASE PARA CODIFICAÇÃO
MANTENEDOR: GUIA PARA MODIFICAÇÕES E EVOLUÇÃO DA ARQUITETURA

- ESPECIFICAÇÃO DE CASOS DE USO
A UML NÃO DEFINE PADRÃO FIXO PARA A DESCRIÇÃO TEXTUAL
A DESCRIÇÃO É MAIS IMPORTANTE QUE O DIAGRAMA
ESTILOS DE DESCRIÇÃO:
INFORMAL: NOME E BREVE TEXTO DA FUNCIONALIDADE
TÍPICA: ATORES, PRÉ-REQUISITOS, FLUXO NORMAL, FLUXOS ALTERNATIVOS
DETALHADA: IDENTIFICADOR, NOME, RESUMO, ATORES, PRÉ-COND. E PÓS-COND., FLUXOS PRINCIPAL, ALTERNATIVOS E DE EXCEÇÃO, RESTRIÇÕES

- ELEMENTOS DA DESCRIÇÃO DETALHADA
IDENTIFICADOR: CÓDIGO ÚNICO (EX.: CSU01, CSU02)
NOME: DEVE CORRESPONDER AO DIAGRAMA
DESCRIÇÃO/RESUMO: OBJETIVO DO ATO
ATOR PRIMÁRIO: INICIA O CASO DE USO (UM ÚNICO)
ATORES SECUNDÁRIOS: APOIAM A INTERAÇÃO (ZERO OU MAIS)
PRÉ-COND: CONDIÇÕES NECESSÁRIAS PARA INICIAR O CASO
PÓS-COND: CONDIÇÕES QUE DEVEM ESTAR PRESENTES AO FINAL
FLUXO PRINCIPAL: SEQUÊNCIA NORMAL DE PASSOS, DO PONTO DE VISTA DO USUÁRIO
FLUXOS ALTERNATIVOS: OPÇÕES OU VARIAÇÕES DE USO
FLUXOS DE EXCEÇÃO: SITUAÇÕES QUE COMPROMETEM O FUNCIONAMENTO

- FORMATOS DE DESCRIÇÃO
CONTÍNUO: TEXTO LIVRE 
NUMERADO: PASSOS SEQUENCIAIS, MAIS ORGANIZADO

- RELACIONAMENTOS NA ESPECIFICAÇÃO
INCLUSÃO (<<INCLUDE>>): COMPORTAMENTO OBRIGATÓRIO, REPETIDO EM MAIS DE UM CASO DE USO
EXTENSÃO (<<EXTENDS>>): COMPORTAMENTO OPCIONAL, INSERIDO EM SITUAÇÕES ESPECÍFICAS
HERANÇA: CASO DE USO FILHO HERDA, SOBRESCREVE OU ACRESCENTA AO CASO DE USO PAI